S  #############
               #
#  #############
#     #  #     #
#  ####  ####  #
#     #  #     #
#  ####  #  ####
#          b   #
#  ####  #  ####
#     #  #     
#############  E