S  ################
   #  #  #     #  #
#  #  #  ####  #  #
#        #     #  #
#  #  #  #  #  #  #
#  #  #  #  #  #  #
#  ####  ####  #  #
#  #           #  #
####  ##########  #
#        #        #
####  #  #  ####  #
#     #     #     
################  E