S  ################
      #     #     #
#  #######  #  ####
#     #        #  #
#  #  #  ####  #  #
#  #     #        #
################  #
#  #        #     #
#  ####  ####  ####
#                 #
####  ####  #  #  #
#     #     #  #  
################  E