S #############
               #
#  #############
#     #  #     #
#  ####  ####  #
#     #  #     #
#  ####  #  ####
#              #
#  ####  #  ####
#     #  #     
#############  