   #############
               #
#  #############
#     #  #     #
#  ####  ####  #
#     #  #     #
#  ####  #  ####
#              #
#  ####  #  ####
#     #  #     
#############  E